########_#_#_#_##_#_#_#_#####
########_#_#_#_##_#_#_#_#####
########_#_#_#_##_#_#_#_#####
########_#_#_#_##_#_#_#_#####
########_#_#_#_##_#_#_#_#####
########_#_#_#_##_#_#_#_#####
########_#_#_#_##_#_#_#_#####
########_#_#_#_##_#_#_#_#####
########________________#####
########________________#####
########________________#####
########________________#####
########________________#####
########________________#####
########________________#####
########________________#####
________################_____
________################_____
________################_____
________################_____
________################_____
________################_____
________################_____
________################_____
#_#_#_#_################_#_#_
#_#_#_#_################_#_#_
#_#_#_#_################_#_#_
#_#_#_#_################_#_#_
#_#_#_#_################_#_#_
#_#_#_#_################_#_#_
#_#_#_#_################_#_#_
#_#_#_#_################_#_#_
