#######_##_####_#_##_###___#_
#_#__#____#____#___#__#____#_
#_#__#____#____#___#__#____#_
#______#__#____#_#__#___###_#
#______#__#____#_#__#___###_#
#_#__#____#____#___#__#____#_
#_#__#____#____#___#__#____#_
#######_##_####_#_##_###___#_
_________#_##_#_#_#_____#_#__
_________#_##_#_#_#_____#_#__
_________#_##_#_#_#_____#_#__
_________#_##_#_#_#_____#_#__
_________#_##_#_#_#_____#_#__
_________#_##_#_#_#_____#_#__
_________#_##_#_#_#_____#_#__
_________#_##_#_#_#_____#_#__
_________#_##_#_#_#_____#_#__
_________#_##_#_#_#_____#_#__
_________#_##_#_#_#_____#_#__
_________#_##_#_#_#_____#_#__
_________#_##_#_#_#_____#_#__
_________#_##_#_#_#_____#_#__
_________#_##_#_#_#_____#_#__
_________#_##_#_#_#_____#_#__
#_#__#____#____#___#__#____#_
#______#__#____#_#__#___###_#
#######_##_####_#_##_###___#_
#_#__#____#____#___#__#____#_
#_#__#____#____#___#__#____#_
#######_##_####_#_##_###___#_
#______#__#____#_#__#___###_#
#_#__#____#____#___#__#____#_
