#############################
#############################
#############################
#############################
#############################
#############################
#############################
#############################
########________________#####
########________________#####
########________________#####
########________________#####
########________________#####
########________________#####
########________________#####
########________________#####
________################_____
________################_____
________################_____
________################_____
________################_____
________################_____
________################_____
________################_____
#############################
#############################
#############################
#############################
#############################
#############################
#############################
#############################
