................................
...........##........#..........
....&#....#....*.....#..........
................................
.....#....#....#.....#.....#....
#...##..#.#.##.##...##..#.......
#....#..#.......#.......#.......
.....#....#.#...................
..........#.....................
.....##...#.....###..#.##.......
.##..##...#.####.###.##....#....
....###..##.###...##.....##.....
.....#....#..#..................
..#.......#.##...#.&...#........
................................
................*...............
.....#....#.....................
#....#....#..##.###@.#.#..#.....
#.#..#.#..#..#..###..####.......
...$##..#.###_##___#.#....##....
###%##.##.######_#####.####.....
#.####.##.#.##.#########........
#.#.#####.#..........#.#........
.....#....#.##...&........#.....
.##..#....#..#.#..#..#..........
#.#..................#.#........
#.#.####..#..#.###..####........
.......##....*.#.....#...#......
..#.###_###..##..##..#...##.....
