................................
...........##........#..........
....&#....#..........#..........
................................
.....#....#....#.....#.....#....
#...##..#.#.##.##...##..#.......
#....#..#.......#.......#.......
.....#....#.#...................
..........#.....................
.....##...#.....###..#.##.......
.##..##...#.####.###.##....#....
....###..##.###...##.....##.....
.....#....#..#.........&........
..#.......#.##...#.....#........
................................
................................
.....#....#.....................
#....#....#..##.###@.#.#..#.....
#.#..#.#..#..#..###..####.......
...$##..#.###_##___#.#....##....
###%##.##.######_#####.####.....
#.####.##.#.##.#########........
#.#.#####.#..........#.#........
.....#....#.##............#.....
.##..#....#..#.#..#..#..........
#.#..................#.#........
#.#.####..#..#.###..####........
.......##......#...&.#...#......
..#.###_###..##..##..#...##.....
