................................
...........##........#..........
.....#....#..........#..........
............&...................
.....#....#....#.....#.....#....
#...##..#.#.##.##...##..#.......
#....#..#.......#.......#.......
.....#....#.#...................
..........#......$.@............
....&##...#....&#%#..#.##.......
.##..##...#.####.###.##....#....
....###..##.###...##.....##.....
.....#....#..#..................
..#.......#.##...#.....#........
................................
................................
.....#....#.....................
#....#....#..##.###..#.#..#.....
#.#..#.#..#..#..###..####.......
....##..#.###_##___#.#....##....
######.##.######_#####.####.....
#.####.##.#.##.#########........
#.#.#####.#..........#.#........
.....#....#.##............#.....
.##..#..&.#..#.#..#..#..........
#.#..................#.#........
#.#.####..#..#.###..####........
.......##......#.....#...#......
..#.###_###..##..##..#...##.....
