................................
...........##........#..........
.....#....#..........#..........
....&...........................
.....#....#....#.....#.....#....
#...##..#.#.##.##...##..#.......
#....#..#.......#.......#.......
.....#....#.#...................
..........#...........$.........
.....##...#.....###..#%##.......
.##..##...#.####.###.##....#....
....###..##.###...##.....##.....
.....#....#..#..................
..#.......#.##...#.....#........
........&.......................
................................
.....#....#..&..................
#....#....#..##.###..#.#..#.....
#.#..#.#..#..#..###..####.......
....##..#.###_##___#.#....##....
######.##.######_#####.####.....
#.####.##.#.##.#########........
#.#.#####.#..........#.#........
.....#....#.##............#.....
.##..#..@.#..#.#..#..#..........
#.#..................#.#........
#.#.####..#..#.###..####........
.......##......#.....#...#......
..#.###_###..##..##..#...##.....
