................................
...........##........#..........
.....#....#..........#..........
................................
.....#....#....#.....#.....#....
#...##..#.#.##.##...##..#.......
#....#..#.......#.......#.....@.
.....#....#.#...................
..........#......$..............
.....##...#.....#%#..#.##.......
.##..##...#.####.###.##....#....
....###..##.###...##.....##.....
.....#....#..#..................
..#.......#.##...#.....#........
................................
................................
.....#&...#.....................
#....#....#..##.###..#.#..#.....
#.#..#.#..#..#..###..####.......
....##..#.###_##___#.#....##....
######.##.######_#####.####.....
#.####.##.#.##.#########........
#.#.#####.#..........#.#........
.....#....#.##............#.....
.##..#....#..#.#..#..#..........
#.#................&.#.#........
#.#.####..#..#.###..####........
.......##......#.....#...#......
..#.###_###..##..##..#...##.....
